38,38,39,39,39,39,39,39,39,39,39,39,39,39,39,39,39,39,39,39,39,0,0,0,0,0,0,0,0,0,0,0,0,0,0,0,0,0,0,0,0,0,0,0,0,0,0,0,0,0,0,0,0,0,0,0,0,0,0,0,0,49,39,39,39,39,39,39
38,38,39,26,76,74,74,76,75,74,75,74,75,74,76,75,76,75,74,76,65,0,0,0,0,0,0,0,0,0,0,0,0,0,0,0,0,0,0,0,0,0,0,0,0,0,0,0,0,0,0,0,0,0,0,0,0,0,0,0,0,37,39,39,39,39,39,39
38,38,26,65,0,0,0,0,0,0,0,0,0,0,0,0,0,0,0,0,0,0,0,0,0,0,0,0,0,0,0,0,0,0,0,0,0,0,0,0,0,0,0,0,0,0,0,0,0,0,0,0,0,0,0,0,0,0,0,0,0,37,39,39,39,39,39,39
38,38,53,0,0,0,0,0,0,0,0,0,0,0,0,0,0,0,0,0,0,0,0,0,0,0,0,0,0,0,0,0,0,0,0,0,0,0,0,0,0,0,0,0,0,0,0,0,0,0,0,0,0,0,0,0,0,0,0,0,0,25,39,39,39,39,39,39
38,38,29,0,0,0,0,0,0,0,0,0,0,0,0,0,0,0,0,0,0,0,0,0,0,0,0,0,0,0,0,0,0,0,0,0,0,0,0,0,0,0,0,0,0,0,0,0,0,0,0,0,0,0,0,0,0,0,0,0,0,25,39,39,39,39,39,39
38,38,53,0,0,0,0,0,0,0,0,0,0,0,0,0,0,0,0,0,0,0,0,0,0,0,0,0,0,0,0,0,0,0,0,0,0,0,0,0,0,0,0,0,0,0,0,0,0,0,0,0,0,0,0,0,0,0,0,0,0,49,39,39,39,39,39,39
38,38,27,50,15,14,15,17,0,0,0,0,0,0,0,0,0,0,0,0,0,0,0,0,0,0,0,0,0,0,0,0,0,0,0,0,0,0,0,0,0,0,0,0,0,0,0,0,0,0,0,0,0,0,0,0,0,0,0,0,64,37,39,39,39,39,39,39
38,38,38,26,27,26,27,28,50,15,14,14,17,0,0,0,0,0,0,0,0,0,0,0,0,0,0,0,0,0,0,0,0,0,0,0,0,0,0,0,0,0,0,0,0,0,0,0,0,0,0,0,0,0,0,0,0,0,0,0,0,37,39,39,39,39,39,39
38,38,38,39,39,39,39,39,26,28,28,26,28,50,14,14,15,14,17,0,0,0,0,0,0,0,0,0,0,0,0,0,0,0,0,0,0,0,0,0,0,0,0,0,0,0,0,0,0,0,0,0,0,0,0,0,0,0,0,0,0,37,39,39,39,39,39,39
38,38,38,39,39,39,39,39,39,39,39,39,39,74,76,75,76,76,65,0,0,0,0,0,0,0,0,0,0,0,0,0,0,0,0,0,0,0,0,0,0,0,0,0,0,0,0,0,0,0,0,0,0,0,0,0,0,0,0,0,0,25,39,39,39,39,39,39
38,38,38,26,75,75,75,74,75,75,76,76,65,0,0,0,0,0,0,0,0,0,0,0,0,0,0,0,0,0,0,0,0,0,0,0,0,0,0,0,0,0,0,0,0,0,0,0,0,0,0,0,0,0,0,0,0,0,0,0,64,39,39,39,39,39,39,39
38,38,26,65,0,0,0,0,0,0,0,0,0,0,0,0,0,0,0,0,0,0,0,0,0,0,0,0,0,0,0,0,0,0,0,0,0,0,0,0,0,0,0,0,0,0,0,0,0,0,0,0,0,0,0,0,0,0,0,0,0,37,39,39,39,39,39,39
38,38,29,0,0,0,0,0,0,0,0,0,0,0,0,0,0,0,0,0,0,0,0,0,0,0,0,0,0,0,0,0,0,0,0,0,0,0,0,0,0,13,15,14,17,0,0,0,0,0,0,0,0,0,0,0,0,0,0,0,0,39,39,39,39,39,39,39
38,38,53,0,0,0,0,0,0,0,0,0,0,0,0,0,0,0,0,0,0,0,0,0,0,0,0,0,0,0,0,0,0,0,0,0,0,0,0,0,0,26,27,28,27,62,17,0,0,0,0,0,0,0,0,15,17,0,0,0,0,25,39,39,39,39,39,39
38,38,53,0,0,0,0,0,0,0,0,0,0,0,0,0,0,0,0,0,0,0,0,0,0,0,0,0,0,0,0,0,0,0,0,0,0,0,0,0,0,0,75,76,75,27,26,62,15,15,14,14,15,16,64,27,65,0,0,0,0,49,39,39,39,39,39,39
38,38,53,0,0,0,0,0,0,0,0,0,0,0,0,0,0,0,0,0,0,0,0,0,0,0,0,0,0,0,0,0,0,0,0,0,0,0,0,0,0,0,0,0,0,0,75,28,28,27,27,28,26,27,27,65,0,0,0,0,0,37,39,39,39,39,39,39
38,38,41,0,0,0,0,0,0,0,0,0,0,0,0,0,0,0,0,0,0,0,0,0,0,0,0,0,0,0,0,0,0,0,0,0,0,0,0,0,0,0,0,0,0,0,0,0,38,38,39,74,76,75,65,0,0,0,0,0,0,37,39,39,39,39,39,39
38,38,53,0,0,0,0,0,0,0,0,0,0,0,0,0,0,0,0,0,0,0,0,0,0,0,0,0,0,0,0,0,0,0,0,0,0,0,0,0,0,0,0,0,0,0,0,0,0,74,65,0,0,0,0,0,0,0,0,0,0,37,39,39,39,39,39,39
38,38,29,0,0,0,0,0,0,0,0,0,0,0,0,0,0,0,0,0,0,0,0,0,0,0,0,0,0,0,0,0,0,0,0,0,0,0,0,0,0,0,0,0,0,0,0,0,0,0,0,0,0,0,0,0,0,0,0,0,0,49,39,39,39,39,39,39
38,38,29,0,0,0,0,0,0,0,0,0,0,0,0,0,0,0,13,14,15,15,15,14,14,17,0,0,0,0,0,0,0,0,0,0,0,0,0,0,0,0,0,0,0,0,0,0,0,0,0,0,0,0,0,0,0,0,0,0,0,37,39,39,39,39,39,39
38,38,53,0,0,0,0,0,0,0,0,0,0,0,0,0,0,64,26,26,26,28,27,27,26,29,0,0,0,0,0,0,0,0,0,0,0,0,0,0,0,0,0,0,0,0,0,0,0,0,0,0,0,0,0,0,0,0,0,0,0,25,39,39,39,39,39,39
38,38,53,0,0,0,0,0,0,0,0,0,0,0,0,0,64,28,39,39,39,74,75,39,39,29,0,0,0,0,0,0,0,0,0,0,0,0,0,0,0,0,0,0,0,0,0,0,0,0,0,0,0,0,0,0,0,0,0,0,0,25,39,39,39,39,39,39
38,38,41,0,0,0,0,0,0,0,0,0,0,0,0,0,0,39,39,39,41,0,48,49,39,53,0,0,0,0,0,0,0,0,0,0,0,0,0,0,0,0,0,0,0,0,0,0,0,0,0,0,0,0,0,0,0,0,0,0,0,25,39,39,39,39,39,39
38,38,53,0,0,0,0,0,0,0,0,0,0,0,0,0,0,0,39,39,53,0,24,25,39,53,0,0,0,0,0,0,0,0,0,0,0,0,0,0,0,0,0,0,0,0,0,0,0,0,0,0,0,0,0,0,0,0,0,0,0,49,39,39,39,39,39,39
38,38,41,0,0,0,0,0,0,0,0,0,0,0,0,0,0,0,39,39,39,50,52,39,39,53,0,0,0,0,0,0,0,0,0,0,0,0,0,0,0,0,0,0,0,0,0,0,13,15,15,16,14,17,0,0,0,0,0,0,0,25,39,39,39,39,39,39
38,38,41,0,0,0,0,0,0,0,0,0,0,0,0,0,0,0,39,27,39,39,39,39,39,65,0,0,0,0,0,0,0,0,0,0,0,0,0,0,0,0,0,0,0,0,0,0,0,28,26,27,27,65,0,0,0,0,0,0,0,25,39,39,39,39,39,39
38,38,41,0,0,0,0,0,0,0,0,0,0,0,0,0,0,0,0,74,76,75,76,76,65,0,0,0,0,0,0,0,0,0,0,0,0,0,0,0,0,0,0,0,0,0,0,0,0,0,27,38,29,0,0,0,0,0,0,0,0,25,39,39,39,39,39,39
38,38,29,0,0,0,0,0,0,0,0,0,0,0,0,0,0,0,0,0,0,0,0,0,0,0,0,0,0,0,0,0,0,0,0,0,0,0,0,0,0,0,0,0,0,0,0,0,0,0,25,38,53,0,0,0,0,0,0,0,0,49,39,39,39,39,39,39
38,38,26,50,0,0,0,0,0,0,0,0,0,0,0,0,0,0,0,0,0,0,0,0,0,0,0,0,0,0,0,0,0,0,0,0,0,0,0,0,0,0,0,0,0,0,0,0,0,0,26,38,29,0,0,0,0,0,0,0,0,61,74,75,75,74,76,39
38,38,27,0,0,0,0,0,0,0,0,0,0,0,0,0,0,0,0,0,0,0,0,0,0,0,0,0,0,0,0,0,0,0,0,0,0,0,0,0,0,0,0,0,0,0,0,0,0,0,49,38,29,0,0,0,0,0,0,0,0,0,0,0,0,0,0,25
38,38,29,0,0,0,0,0,0,0,0,0,0,0,0,0,0,0,0,0,0,0,0,0,0,0,0,0,0,0,0,0,0,0,0,0,0,0,0,0,0,0,0,0,0,0,0,0,0,0,25,38,41,0,0,0,0,0,0,0,0,0,0,0,0,0,0,37
38,38,53,0,0,0,0,0,0,0,0,0,0,0,0,0,0,0,0,0,0,0,0,0,0,0,0,0,0,0,0,0,0,0,0,0,0,0,0,0,0,0,0,0,0,0,0,0,0,0,49,38,53,0,0,0,0,0,0,0,0,0,0,0,0,0,0,49
39,39,27,50,15,15,14,15,14,15,15,15,15,14,15,15,15,14,15,14,14,15,15,14,15,14,14,15,14,14,15,15,15,14,14,14,15,15,14,15,14,15,15,14,15,14,14,15,14,52,39,38,26,50,14,15,15,16,13,16,13,14,14,14,15,16,52,39
39,39,26,28,27,26,27,28,26,26,27,27,27,28,28,28,28,28,27,26,26,26,27,28,26,26,28,26,28,27,28,27,28,26,28,27,28,28,28,26,27,28,28,26,28,27,26,26,28,39,39,39,26,27,28,27,27,28,26,27,26,27,26,26,28,26,27,28
39,39,39,39,39,39,39,39,39,39,39,39,39,39,39,39,39,39,39,39,39,39,39,39,39,39,39,39,39,39,39,39,39,39,39,39,39,39,39,39,39,39,39,39,39,39,39,39,39,39,39,39,39,39,39,39,39,39,39,39,39,39,39,39,39,39,39,39
